0,0,0,1,1,1,1,1,1,1,0,0,0
0,0,0,1,2,1,2,1,0,1,0,0,0
0,0,0,1,0,1,0,1,0,1,0,0,0
0,0,0,1,0,1,0,1,2,0,1,1,1
1,1,1,0,0,0,2,1,6,0,0,0,1
0,0,0,2,0,5,5,0,0,0,0,0,1
1,1,1,1,1,0,5,1,1,1,1,1,1
0,0,0,0,1,1,0,1,1,1,0,0,0
0,0,0,0,0,1,3,1,0,0,0,0,0
0,0,0,0,0,1,1,1,0,0,0,0,0