0,0,0,0,0,0,4,0,0,1,0,0,0
0,0,0,0,0,0,4,0,0,1,0,1,0
0,0,2,0,0,0,5,0,0,1,0,1,0
0,0,0,0,0,6,1,1,0,4,0,1,0
0,0,0,0,0,2,1,2,0,5,5,3,4
0,0,0,0,0,6,1,1,0,1,1,1,0
0,0,0,0,0,0,5,0,0,4,0,1,0
0,0,2,0,0,0,4,0,0,1,0,1,0
0,0,0,0,0,0,4,0,0,1,0,1,0
0,0,0,0,0,0,4,0,0,1,0,0,0