0,0,0,0,1,0,0,0,0,0,0,0,0
0,0,0,0,1,0,2,0,0,0,0,0,0
0,0,0,0,1,0,0,0,0,0,0,0,0
0,0,0,0,1,1,1,0,0,1,5,1,0
0,0,0,0,5,2,1,0,0,5,3,1,0
0,0,0,0,1,1,1,0,0,1,5,1,0
0,0,0,0,1,0,0,0,0,0,0,0,0
0,0,0,0,1,0,0,0,0,0,0,0,0
0,0,0,0,1,0,2,0,0,0,0,0,0
0,0,0,0,1,0,0,0,0,0,0,0,0