0,0,0,0,0,1,0,0,0,0,0,0,0
0,0,0,0,0,1,0,0,0,0,0,0,0
0,0,0,0,0,1,1,1,1,1,1,1,1
0,0,0,0,0,1,0,0,0,0,0,0,0
0,0,0,0,0,1,0,0,2,6,0,0,0
0,0,0,0,0,1,0,0,0,0,0,0,0
1,1,0,0,1,1,0,0,1,5,1,0,0
0,0,0,0,0,0,0,0,1,3,1,0,0
0,0,6,2,0,0,0,0,1,1,1,0,0
0,0,0,0,0,1,0,0,0,0,0,0,0